%%%%%%%%%%%%%%%%%%%%%%%%%
%.. P  ....      ....   %
%..  ...  ...  ...  ... %
%..  ...  ...  ...  ... %
%.. P  ....      .... G %
%..  ...  ...  ...  ... %
%..  ...  ...  ...  ... %
%.. P  ....      ....  o%
%%%%%%%%%%%%%%%%%%%%%%%%%
